               .:-==+++=           :::::::-        
            :+*####**+-:=          -::::-+=---+=   
            %@=  :::::-:.=         ::   --=   +-   
           .@@. - .  =+ :=:         .-.:=::::=:    
           -==  =.   . .- +           -=.  --:     
           =:    --:.:--  +          .=-:  -::     
           :==     ...   :=   :++++++++++**++****- 
             --         ==         -=:===+-.       
               --     -=.           =+ :=.         
                .+:. :*            .+.:-           
               .*@+%*+@+           *-+-            
              .%@@%- -@@#.       .#@@+             
             :%@@@@+ =#-*@+.   .=%@@+              
            -@@@@@@%.+*:*@@@%%%@@@%-               
           =@@@@@@@@=#@@@@@@@@@@@*.                
          =@@@@@@@@@@@@@@#=*##*+.                  
         +@@@*%@@@@@@@@@@%                         
        =@@@@===**#%*+++#@---:::.                  
        -*%@@.  .:.     =# + .-=++.                
           .=           -@=-:+==.                  
            =           -@=                        
           .=           =@*                        
           ::           =@#                        
           ----+=--:-=+*#@@                        
              :@@@@@@@@@@@@.                       
              .@@@@@@@@@@@@-                       
               @@@@@=:%@@@@=                       
               %@@@@. -@@@@*                       
               #@@@#   +@@@#                       
               +@@@=   .@@@@                       
               -@@@:   =@@@@.                      
               :@@@.  -@@@%-                       
               .@@@. -@@@#.                        
                %@@..%@@=                          
                *@@.:%%:                           
                =@#.  *#+=                         
              ::=%*                                
              -*= 