                      :.:.                            
                    ::=+::.                           
                  ::=+++=::                           
                 .-+++++**+.                         
               .-++++***+-..                         
              :+++++*+-- ::--::       --              
            .=****++=:. :+======:   :+=               
          .-****=::+*+=-+========.:=*+.               
        -==+++-.   -++**===-++++=+**+-                
       :=+*+=:      ---=====+==++++-.                 
      :+**+=+.         :+===+++++-.                  
    .+*=::-=---.        -++++++++                    
    .:.    :+===-.   :-====++++=-                     
            :+====::=========**+=-:.                  
             .+============++==-+===-.                
              .=+++==-+==++=----+*+====:.             
                 .    =++=----=-+.:======-:.          
                      ==-----==-=    .:-====-:.       
                      :=----====-        .-=====-:    
                      .=---==-==:          .=+-+--.   
                      =*===+*+++*=.         -- -.     
                     :+**********+==-::        .      
                   .-==****+*+***=======-.            
                  .=====*+#*++*=++++=====-            
                 .=====+=+***-=   .======:            
               .-=+*++-. .=+*.    :=====-             
             .=****+:      ::    .+====-              
          ..-*+***:              ++++*:               
           ******:=.            .****+                
           :+******:            =****. .              
             ::----.           .******++              
                                .:----=: 