                                                       
                      ..                ..                       
                     .:                  ::                      
               .     :.:......:--:..::..:.:      .               
             .--:.   .-:...+=+====+++:..:-.    .::-:             
      .+=.:-====--:    :-=*=-+===++++*=:.     .--===+=:.-+:      
 .::::-#*+=======-=:      -*==+++++=*-       .=-=======+**=::::. 
 .-=====++=-======--.    .=++=====++*=:      --======-==++=====: 
 .-======+++:--====--    :=*-==--+=-*=-     :-=====-:=++======-. 
  -====- .*%=   .-+=-.   =-**==--==+*-=.    --+=:   :%#: :====-  
  .-===   .#%-    .=::   -.:+===++-*-::.   .:=:    .#%:   -=+-.  
   .-==    .##:   .:--:::=-::+=-===-:-=::::-:-    .#%:    ===.   
     :=:    .##: :-::::-==+=-:.-::::=++--:::---. .*#-    .=:     
       ..    -##--::::-+=-:==-:-::-==---=+-::-:-:*%=    ..       
            :-=##==-==#=:...:-=+*==-:...-**==-==##+-             
          .:--=+=-*=+%*::.::::-+#=-:::..:-%%+-+==++--:.          
         .--:=+:-=-==++=---==*++*=+==-:.:++*--==-:=+::=.         
         ::=++--===+-+-+=++-=:::+::-=+++=+==:+====-++=:-         
          =::===+=*%==-+-+--=--=*---=:===+=::%#=+==+-:=.         
          .*=--=--=#%-:=-+--=:::=:::=-=-==::#*==----=*-          
           :-==--. :##:.===-+-=======-=-- .#*: .::===-           
                    -##.:==-+=---:-+=-+=  *#+                    
                     =*--:-=+=-=+--+==:- :*+                     
                        :=---==-+-==-::-                         
                        -===-=======--=-:     