

                    ===============================================
                    =                                             =
                    =   .##.....##.########.##....##.##.....##    =
                    =   .###...###.##.......###...##.##.....##    =
                    =   .####.####.##.......####..##.##.....##    =
                    =   .##.###.##.######...##.##.##.##.....##    =
                    =   .##.....##.##.......##..####.##.....##    =
                    =   .##.....##.##.......##...###.##.....##    =
                    =   .##.....##.########.##....##..#######.    =
                    =                                             =
                    ===============================================

