                       ..-.                                                                         
                 .....:::...:..                                                                     
               :.            .-.                                                                    
             :-    ..-::.::-   =..                                                                  
            ::   . .:.     .+.  =:                                                                  
            =   *.  -       +-  -                                                                   
           .=   .. :.      =.-  --                                                                  
           = ::#=..      .=.-   --                                                                  
           -=#*:        :::-   -               .::......                                            
            .:.       :-.:.   =-            :::         :::                        ..               
                    --.::   .--          .-:           ::::::                  ....  :::            
      ......      :- .-    =:           -:.:               -:-:               .    .... -           
  ....      .....-::-.   .==           -:..       .:.      . ..:    .....    :   :.    :.::..:-     
..             .=  -    :+...   ......= ..     ::.   .::       ::...     ...- : ::..... .:....    ..
..............:- :-    .+-...........=       .+.........=.      =...........-.  -.......:::::::::...
              =..=     *            .-       =           =      :.          -   -                   
             =  :.    .+:           =       =             -      =          =   -                   
           .:=::=::::.::..         ..........           ..:......:         .:...:.                  
                                                                                              
                                                                                                                                                                                                   
                                                                                                    
====++++=============================================++++===========================================
@@%+*#@#%@@@@#@%%@%%@@@@@@@@@@@@@@@@@@@@@@@@@@@@@@@@@@@@@@@@@@@@@@@@@@@@@@@@@@@@@@@@@@@@@@@@@@@@@@@@
@@#*=#%##*###**#####%#@@@@@@@@@@@@@@@@@@@@@@@@@@@@@@@@@@@@@@@@@@@@@@@@@@@@@@@@@@@@@@@@@@@@@@@@@@@@@@
