                             -+=++=:                               
                        :-=--: .-. .----:                          
                     :==:      .=:      :---                       
                   .+:  =: :#  .+=     :-  .==.                    
              .:: =-       :.  .+-    .-.    .+==---               
            -=-:-*+ .+   .-+   .+-  ..:    -. .#   .+.             
           .+     *- --.        :.   --  .:=. -#.   .*             
           =-.:   :*       .. -.+:   .        +#+.  :=-            
           -+ =  ::*: -+== =-:= :-.  :.  - -- *%*   ++-            
            #..:   .*-  .       .      =-:.:.=##:   =#.            
            :*:.=  -:=*- -=- :  -+-   ::   -=**=  .=-#             
             =*+**: .:.=*=:.++   .   :-- :-+*-=  :=:*==            
            .%  -%%+.    -*+.   :+:    -=+*--:  -=++ .#            
            :*  -+:+*-   -:.++.  ::  .*++:--  -*#==+  %            
            .#  ==.--*-    .--*-:::.=+- ..  :=#*. == :%            
             *- -#=.--*=     :-+-  #:.=:   =-%+==:%: +*            
             .#..% *:=:#+:-:  . % -=:- :. .-%=-:+:# :%.            
              .*=#.+*-*-**-:.   %.==-:  :::#-=-*+ ==+*             
               -=.  -=- =++#-. =# .#.-:  =#*=:=#     #             
               *  --+ +-=-.#+==-   .===+#+-:=+.-+-.  #             
               #  -*++..-==-+--       :=+:--:  *#*  :+             
               #  #-==*=:    -  .**-.  -=-:  :=##=  =:             
               +:-#---.   = .  .#%#%-= :=*--=.=##:  *              
              .#*++ -- :==..-:-#*. =+==--.  .*=*=. .*              
             .%*.==.* += :==:==.     .===*#- *- .*: #              
             :+ .#.*:-=:*- .-=++=*%*--=+...#+== .*===-             
               -+.=+ #+%.::++*+-.@%@#:-++==-%=#.=- :+#             
              :+:**:.@*+ =.:.:- =*=.%. :=-=*#=*#*.  =%             
              #+= +:=#+-        *.-.*-  .   +-*.-*   -             
              *+.*==+ %.       .+:::++      .*++ -*                
              :*%+:  #=        =:    *       *.:*:=+               
               .    *@:    .   *:    *. .=   .# .*=#+.   .         
                  .+*#.   +:  =:=-   #:  :+   =+  -+.:---:-=-:     
          .----=---+-=-  .*   * .*   #*   %+:  :=+..-::.. .:.:*.   
       :==-.      -= :+  -=   *  -+  #*.  *.*-   .=*..:::--.==-*.  
     -+:         :*  +-  =-   *   -- *.*  -= *+    :*.        =+#  
    +:       :=. *. +@   *-  .*  :%- --=-  *: +#.   .+=..      .%+ 
   =- .-=====-  -= .##  +%.  --  *:+  *.*  .*: =%=    .:-++     .*-
  .*.+=.       .*  *-* -+#   -- -= *. --+:   *:  +%--=-=: =+       
 .*=+.        ==  +-== #.#   =+ -- .*. *.#.   =+=--+    :++%:      
-+*:        :+.  =+ +--= #   *# -=  .+ :+.*-   -+:=@-     :#*      
**.        =- :==.  #.#. *.  #+::=   * .*  -*.  +- -@*.     -      
=.        =: :*    -+ #  =-  *-=:+   =- #   .=+: #. :%*=           
         := -*    .#. #  =:  =-* *    * #      +=:*. :*#.          
         *.-+     -= ==  +:  *.*.*    +:+:      :+-+=              
         #==      *-+=   *. -= -=#     +=+        +===             
        .*#      =**.    # .*  .**.     **.        -+*.            
        :#+     =**.    .# +:   #+:     :*+         =#=            
        :%=     #*.     -= #    +=+      *#.         =#            
        =#      %*      :+-=    +:*      .#+          .            
        +-      @:       *#.    *+:       =*                       
                %         .     *=                                 