                    ...                                          
                 =%++++*%-                                       
         -+++++++@=     #*         :----.                        
  +*****@=.     .@=     #*     .+#*=-::-+#+                      
 =%    @+        %=     #*    -@-         =%.                    
  +***%@+.......:@=     #*   :@:           +-                    
     :@:-+@#+++*@@=     #*   #*          +#%**:                  
     %=   ##===#*+%====+@-   @= ==  -+  +%:@ -@                  
    =%     ...#*   .....    :@* .:  .. .%+.@+##                  
    #+        %+           .%+*#%*   +#*-  @+-%#*+-.             
    @-       -@#=:    .::-%%@   =%++%+     #+ ** .-*#+:          
    @-     -##. :=*@%*+==@++%     ..       +% #+     :*#-        
    =%==+##+.    .%+    =% =%              -@ #+       .+%-      
      ::+%.     .%=     @= .@:             *# #*         .*#.    
         -%:    %*     =@   #%            =@. **        .=##%-   
          :%+  -@.     %*   #%%-*%.     .#@=  +%      -#*-  .@=  
            +%=##     .@-   #+.=:-%+. -##:#+  .@:   :%*.     :@. 
             .+@#.    =@    *#     -**=.  **   -@- :%:        %+ 
                -*#=. *%    .%*.         .%=    .#*.          ** 
                   -*#%*      -*#*******#*-       -@-         #+ 
                     :@+                           *@+***+-  .@: 
                      *:     -===-       :+******=-=:.  .:=#*##  
 -++++++++++++++++++++++++++@+:::=%*====*%.      =@=========#@+: 
 **                        .@-     .::::@=        %+::::::::::*# 
 =**#@#*******************+ :********@%*@=        ##******#@@**= 
    .@:                             -@: =%:              -#%.    
     %+                        .-=+#*.   .*#+-:.....:-+##=#*     
      =*#+                   =%+-:.         .:-=+++==-.   **     
         =@:                %*                            **     
          =%               =%                             **     
          .@.              +#                             **     
           *****************=                             -=     
