                        
                 =============================================================================================================================================================
                 =                                                                                                                                                           =        
                 =   .########...#######..##....##.......##..#######..##....##....########.########....########...#######..##.....##.########..########...#######..##....##  =
                 =   .##.....##.##.....##.###...##.......##.##.....##.###...##....##..........##.......##.....##.##.....##.##.....##.##.....##.##.....##.##.....##.###...##  =
                 =   .##.....##.##.....##.####..##.......##.##.....##.####..##....##..........##.......##.....##.##.....##.##.....##.##.....##.##.....##.##.....##.####..##  =
                 =   .##.....##.##.....##.##.##.##.......##.##.....##.##.##.##....######......##.......########..##.....##.##.....##.########..########..##.....##.##.##.##  =
                 =   .##.....##.##.....##.##..####.##....##.##.....##.##..####....##..........##.......##.....##.##.....##.##.....##.##...##...##.....##.##.....##.##..####  =
                 =   .##.....##.##.....##.##...###.##....##.##.....##.##...###....##..........##.......##.....##.##.....##.##.....##.##....##..##.....##.##.....##.##...###  =
                 =   .########...#######..##....##..######...#######..##....##....########....##.......########...#######...#######..##.....##.########...#######..##....##  =
                 =                                                                                                                                                           =
                 =============================================================================================================================================================
                                                                                  Projet C# 3 eme année ENIGMA

                                                                                            


                                                                                




                                                                                                                  
                                                                                                                                        Appuyez sur Entrée pour continuer...
